30.ox
2.................2.....22....
.................2.........2..
...............2..............
.......2........2............2
...2................2.........
............2.................
2...2........2................
..2........................2..
..............................
..2...........................
...............2..22..........
.................2............
......2.............2.2......2
.....2...........2........22..
....2...............2....2....
..........2..2....22..........
...2....2.....................
......2..............2........
...2..........................
................2.............
...2......2...2...............
...2...2................2.....
....22.......2.22.............
..........2...................
...2..2.....................2.
................2.............
..............................
..2.........................2.
..............................
........................2....2
