30.ox
o.................o.....oo....
.................o.........o..
...............o..............
.......o........o............o
...o................o.........
............o.................
o...o........o................
..o........................o..
......xxxx....................
..o...xxxx....................
......xxxx.....o..oo..........
......xxxx.......o............
......o.............o.o......o
.....o...........o........oo..
....o...............o....o....
..........o..o....oo..........
...o....o.....................
......o..............o........
...o..........................
................o.............
...o......o...o...............
...o...o................o.....
....oo.......o.oo.............
..........o...................
...o..o.....................o.
................o.............
..............................
..o.........................o.
..............................
........................o....o
