30123
111111211111121111112111111111
111111111111111211111111111111
111111111112111111111112211111
111111111111111111111111111111
111111111111111211222111111111
121111111111111111111111111111
111211111111121111111111112111
111111111111111111111111111111
121111111111111111111111111111
122111111111121111112111111221
121111111121111111111111111111
111111211111111111111111112111
111121111111111111212211111111
111121112111212111111111111111
211111111111111122111111112211
121111111111111111111111111111
111111111111211111111111211111
121111111211111112111121121111
111111112112112111111211111111
111111111111111111211111111112
112111111111111111111111111111
211111211112111111112111111111
111111121112111111111111112111
111111121121111211111111111111
111111111111111111111111111111
111111111111111211211111111212
111111111211111121211211111111
121211111111111111111211211112
111111111111111112121212111121
111111111211111121211111111111
